type octile
height 125
width 125
map
............................................................
....................................................S.......
............................................................
............................................................
............................................................
.............................S..............................
............................................................
............................................................
....................................@@@@....................
..............S.............................................
................................@...........................
................................@......S....................
................................@...........................
................................@@@@........................
.@@@@@@.....................................................
.@....@........S............................................
.@.@@.@.................................@...................
.@..@.......................................................
.@@.@@@@@@..................................................
.@@.@@@.....................................................
............................................................
...S........................................................
............................................................
............................................................
....................................................S.......
............................................................
............................................................
............................................................
.............................S..............................
............................................................
............................................................
....................................@@@@....................
..............S.............................................
................................@...........................
................................@......S....................
................................@...........................
................................@@@@........................
.@@@@@@.....................................................
.@....@........S............................................
.@.@@.@.................................@...................
.@..@.......................................................
.@@.@@@@@@..................................................
.@@.@@@.....................................................
............................................................
...S........................................................
............................................................
............................................................
....................................................S.......
............................................................
............................................................
............................................................
.............................S..............................
............................................................
............................................................
....................................@@@@....................
..............S.............................................
................................@...........................
................................@......S....................
................................@...........................
................................@@@@........................
.@@@@@@.....................................................
.@....@........S............................................
.@.@@.@.................................@...................
.@..@.........................G.............................
.@@.@@@@@@..................................................
.@@.@@@.....................................................
............................................................
...S........................................................
............................................................
............................................................
....................................................S.......
............................................................
............................................................
............................................................
.............................S..............................
............................................................
............................................................
....................................@@@@....................
..............S.............................................
................................@...........................
................................@......S....................
................................@...........................
................................@@@@........................
.@@@@@@.....................................................
.@....@........S............................................
.@.@@.@.................................@...................
.@..@.......................................................
.@@.@@@@@@..................................................
.@@.@@@.....................................................
............................................................
...S........................................................
............................................................
............................................................
....................................................S.......
............................................................
............................................................
............................................................
.............................S..............................
............................................................
............................................................
....................................@@@@....................
..............S.............................................
................................@...........................
................................@......S....................
................................@...........................
................................@@@@........................
.@@@@@@.....................................................
.@....@........S............................................
.@.@@.@.................................@...................
.@..@.......................................................
.@@.@@@@@@..................................................
.@@.@@@.....................................................
............................................................
...S........................................................
............................................................
................................@@@@........................
.@@@@@@.....................................................
.@....@........S............................................
.@.@@.@.................................@...................
.@..@.......................................................
.@@.@@@@@@..................................................
.@@.@@@.....................................................
............................................................
...S........................................................
............................................................
............................................................
